WWWWWWWWWWWWWWWWWWWWWWWWWWWWWW
W             WW             W
W   WWWWWWW   WW     G       W
W   W  O  W   WW             W
W   WW   WW                  W
W                  WWWWW     W
W             WW    W        W
W      P      WW    W     H  W
W             WW    W        W
WWWWWWWWWWWWWWWWWWWWW   WWWWWW
WWWWWWWWWWWWWWWWWWWWW   WWWWWW
W             WW             W
W         W   WW     G       W
W         W   WW             W
W   WWWWWWW                  W
W                 WWW   WWWWWW
W             WW    W        W
W      G      WW    W     H  W
W             WW    W        W
WWWWWWWWWWWWWWWWWWWWWWWWWWWWWW
