WWWWWWWWWWWWWWWWWWWWWWWWWWWWWWWWWWWWWWWWWWWWWWWWWWWWWWWWWWWW
W             WW             WW             WW             W
W   WWWWWWW   WW     G       WW   WWWWWWW   WW     G       W
W   W     W   WW             WW   W     W   WW             W
W   WW   WW                  WW   WW   WW                  W
W                  WWWWW     WW                  WWWWW     W
W             WW    W        WW             WW    W        W
W       M     WW    W     H  WW       M     WW    W     H  W
W             WW    W        WW             WW    W        W
WWWWWWWWWWWWWWWWWWWWW   WWWWWWWWWWWWWWWWWWWWWWWWWWW   WWWWWW
WWWWWWWWWWWWWWWWWWWWW   WWWWWWWWWWWWWWWWWWWWWWWWWWW   WWWWWW
W             WW             WW             WW             W
W     M   W   WW     G       WW         W   WW     G       W
W         W   WW                        W   WW             W
W   WWWWWWW                       WWWWWWW                  W
W           M     WWW   WWWWWWW                 WWW   WWWWWW
W             WW    W        WW      M      WW    W        W
W      G      WW    W     H  WW      G      WW    W     H  W
W             WW    W        WW             WW    W        W
WWWWWWWWWWWWWWWWWWWWW   WWWWWWWWWWWWWWWWWWWWWWWWWWW   WWWWWW
WWWWWWWWWWWWWWWWWWWWW   WWWWWWWWWWWWWWWWWWWWWWWWWWW   WWWWWW
W             WW             WW             WW             W
W         W   WW    WWWWW    WW     M   W   WW     G       W
W         W   WW    W S W    WW         W   WW       M     W
W   WWWWWWW         W   W         WWWWWWW                  W
W                     B                         WWW   WWWWWW
W             WW             WW             WW    W        W
W   M  G      WW      P      WW      G      WW    W     H  W
W             WW             WW             WW    W        W
WWWWWWWWWWWWWWWWWWWWWWWWWWWWWWWWWWWWWWWWWWWWWWWWWWWWWWWWWWWW
